árgangur	árg
árgangi	árg
blaðsíða	bls
blaðsíðu	bls
blaðsíður	bls
danskar krónur	dkr
ferkílómetra	km²
ferkílómetrar	km²
ferkílómetrum	km²
fermetra	m²
fermetrar	m²
fermetrum	m²
gráða	°
gráðu	°
gráður	°
gráðum	°
grein	gr
greinar	gr
gígavatt	gw
gígavatti	gw
gígavött	gw
gígavöttum	gw
gígavatta	gw
gígavattstund	gwst
gígavattstunda	gwst
gígavattstundir	gwst
gígavattstundum	gwst
íslenskar krónur	ísl kr
íslenskra króna	ísl kr
íslenskum krónum	ísl kr
kílógramm	kg
kílógrammi	kg
kílógrömm	kg
kílógrömmum	kg
kílógramma	kg
kílómetri	km
kílómetra	km
kílómetrar	km
kílómetrum	km
kílóvatt	kw
kílóvatti	kw
kílóvött	kw
kílóvöttum	kw
kílóvatta	kw
kílóvattstund	kwst
kílóvattstunda	kwst
kílóvattstundir	kwst
kílóvattstundum	kwst
króna	kr
krónu	kr
krónum	kr
krónur	kr
metri	m
metra	m
metrar	m
metrum	m
málsgrein	mgr
málsgreinar	mgr
megavatt	mw
megavatti	mw
megavött	mw
megavöttum	mw
megavatta	mw
megavattstund	mwst
megavattstundir	mwst
megavattstundum	mwst
megavattstunda	mwst
norskar krónur	nkr
prómill	‰
prómill	‰
prómilli	‰
prómills	‰
prómillum	‰
prómilla	‰
prósent	%
prósenti	%
prósents	%
prósentum	%
prósenta	%
sentímetri	cm
sentímetra	cm
sentímetrar	cm
sentímetrum	cm
sænskar krónur	skr
teravatt	tw
teravatti	tw
teravött	tw
teravöttum	tw
teravatta	tw
teravattstund	twst
teravattstundir	twst
teravattstundum	twst
teravattstunda	twst
